10 20
#...................
#..............#....
#.......#......##...
.......##......##...
......####.....##..#
........###........#
...##...............
..###........####...
.............#..#...
........###.........